211111111112
100000000001
100000000001
100000100001
100000100001
100011211001
100000100001
100000100001
100000000001
100000000001
100000000001
100000000001
100000000001
100000000001
100000000001
100000000001
100000000001
211111111112